{
  "levels": [
    {
      "levelNumber": 1,
      "time": 120,
      "chipNumber": 1,
      "optionalFields": [
        { "fieldType": "levelTitle", "value": "First one" },
        { "fieldType": "hintText", "value": "First one" },
        { "fieldType": "encodedPassword", "value": [222,222,222,222]},
        {
          "fieldType": "movingObjectsPos",
          "value": [
            { "x" : 8, "y" : 1 },
            { "x" : 10, "y" : 1 },
            { "x" : 9, "y" : 6 }
          ]
        }
      ],
      "upperLayer": [1,  1,  1,  1,  1,  1,  1,  1,  1,  1,  1,  0,  0,  0,  0,  0,  0,  0,  0,  0,  0,  1,  1,  1,  1,  1,  1,  1,  1,  1,  1,  1,
            1,  3,  3,  3,  3,  3,  3,  3,  3,  3,  1,  0,  0,  0,  0,  0,  0,  0,  0,  0,  0,  1, 12, 12, 12, 12,  0, 12, 12, 12,105,  1,
            1,  3,  3,  3,  3,  3,  3,  3,  3,  3,  1,  0,  0,  0,  0,  0,  0,  0,  0,  0,  0,  1, 12, 12, 12, 12, 12, 12, 12,  1, 12,  1,
            1,  3,  3,  3,  3,  3,  3,  3,  3,  3,  1,  0,  0,  0,  0,  0,  0,  0,  0,  0,  0,  1, 12, 12, 12, 12, 12, 12, 12, 12, 12,  1,
            1,  3,  3,  3,  3,  3,  2,  3,  3,  3,  1,  0,  0,  0,  0,  0,  0,  0,  0,  0,  0,  1,  0, 12, 12, 12,  0, 12,  1, 12, 12,  1,
            1,  3,  3,  3,  3,  3,  3,  3,  3,  3,  1,  0,  0,  0,  0,  0,  0,  1,  1,  1,  1,  1, 12, 12, 12, 12, 12,  1,  0, 12,  0,  1,
            1,  3,  3,  3,  3,  3,  3,  3,  3,  3,  1,  0,  0,  0,  0,  0,  0,  1, 13, 20, 20, 20,  0, 12, 12, 12,  1, 12, 12, 12, 12,  1,
            1,  3,  3,  3,  3,  3,  2,  3,  3,  3,  1,  0,  0,  0,  0,  0,  0,  1, 13,  1,  1,  1,  1, 12, 12, 12,  0, 12,  0, 12, 12,  1,
            1,  3,  3,  3,  3,  3,  3,  3,  3,  3,  1,  0,  0,  0,  0,  0,  0,  1, 13,  1,  0,  1,  0, 12, 12,  0, 12, 12, 12, 12, 12,  1,
            1,  3,  3,  3,  3,  3,  3, 13,  3,  3,  1,  1,  1,  1,  1,  1,  0,  1, 13,  1,  0,  1,103, 12, 12, 12,  0, 12, 12, 12, 12,  1,
            1,  1,  1,  1,  1,  1, 18, 13,  1,  1,  1,  1, 19, 19, 13,  1,  0,  1, 13,  1,  0,  1,  1,  1,  1, 18,  1,  1,  1,  1,  1,  1,
            0,  0,  0,  0,  0,  1, 18, 13,  1,  1,  1,  1, 18,  1, 13,  1,  1,  1, 13,  1,  0,  0,  0,  0,  1, 18,  1,  0,  0,  0,  0,  0,
            0,  0,  0,  0,  0,  1, 18, 19, 19, 19, 19, 19, 18,  1, 13,  1, 21,  1, 13,  1,  0,  0,  0,  0,  1, 18,  1,  0,  0,  0,  0,  0,
            0,  0,  0,  0,  0,  1, 18,  1,  1,  1,  1,  1,  1,  1,  0,  0, 34,  0,  0,  1,  1,  1,  1,  1,  1, 18,  1,  0,  0,  0,  0,  0,
            0,  0,  0,  0,  0,  1, 18, 20, 20, 20, 20, 20, 20, 22,  0,  0,  0,  0,  0, 19, 19, 19, 19, 19, 19, 18,  1,  0,  0,  0,  0,  0,
            0,  0,  0,  0,  0,  1,  1,  1,  1,  1,  1,  1,  1,  1,  0,  0,108,  0,  0,  1,  1,  1,  1,  1,  1,  1,  1,  0,  0,  0,  0,  0,
            0,  0,  0,  0,  0,  1,  1,  1,  1,  1,  1,  1,  1,  1,  0,  0,  0,  0,  0,  1,  1,  1,  1,  1,  1,  1,  1,  0,  0,  0,  0,  0,
            0,  0,  0,  0,  0,  1, 13, 20, 20, 20, 20, 20, 20, 20,  0,  0, 47,  0,  0, 25, 19, 19, 19, 19, 19, 13,  1,  0,  0,  0,  0,  0,
            0,  0,  0,  0,  0,  1, 13,  1,  1,  1,  1,  1, 19, 19,  0,  0,  0,  0,  0,  1,  1,  1,  1,  1,  1, 13,  1,  0,  0,  0,  0,  0,
            0,  0,  0,  0,  0,  1, 13,  1,  0,  0,  0,  1, 18,  1,  0,  1,  1,  1, 18,  1,  0,  0,  0,  0,  1, 13,  1,  0,  0,  0,  0,  0,
            0,  0,  0,  0,  0,  1, 13,  1,  0,  0,  0,  1, 18,  1, 18,  1,  0,  1, 18,  1,  0,  0,  0,  0,  1, 13,  1,  0,  0,  0,  0,  0,
            1,  1,  1,  1,  1,  1, 13,  1,  1,  1,  1,  1, 18,  1, 18,  1,  0,  1, 18,  1,  0,  1,  1,  1,  1, 13,  1,  1,  1,  1,  1,  1,
            1,  0,  0,  0,  0,  0,  0,  0,  0,  0, 19, 19, 18,  1, 18,  1,  0,  1, 18,  1,  0,  1,  4,  4,  4,  4,  4,  4,  4,  4,  4,  1,
            1,  0,  0, 10,  0,  0,  0, 10,  0,  0,  1,  1,  1,  1, 18,  1,  0,  1, 18,  1,  0,  1,  4,  4,  4,  4,  4,  4,  4,  4,  4,  1,
            1,  0,  0,  0,  0,  0,  0,  0,  0,  0,  1,  1,  1,  1, 18,  1,  0,  1, 18,  1,  1,  1,  4,  4,  4,  4,  4,  4,  4,  4,  4,  1,
            1,  0,  0,  0,  0,  0,  0,  0,  0,  0, 19, 19, 19, 19, 18,  1,  0,  1, 18, 20, 20, 20,  0,  4,  4,  4,  4,  4,  4,  4,  4,  1,
            1,  0,  0,  0,  0, 72,  0,  0,  0,  0,  1,  1,  1,  1,  1,  1,  0,  1,  1,  1,  1,  1,  4,  4,  4,  2,  4,100,  4,  4,  4,  1,
            1,  0,  0,  0,  0,  0,  0,  0,  0,  0,  1,  0,  0,  0,  0,  0,  0,  0,  0,  0,  0,  1,  4,  4,  4,  4,  4,  4,  4,  4,  4,  1,
            1,  0,  0,  0,  0,  0,  0,  0,  0,  0,  1,  0,  0,  0,  0,  0,  0,  0,  0,  0,  0,  1,  4,  4,  4,  4,  4,  4,  4,  4,  4,  1,
            1,  0,  0, 10,  0,  0,  0, 10,  0,  0,  1,  0,  0,  0,  0,  0,  0,  0,  0,  0,  0,  1,  4,  4,  4,  4,  4,  4,  4,  4,  4,  1,
            1,  0,  0,  0,  0,  0,  0,  0,  0,  0,  1,  0,  0,  0,  0,  0,  0,  0,  0,  0,  0,  1,  4,  4,  4,  4,  4,  4,  4,  4,  4,  1,
            1,  1,  1,  1,  1,  1,  1,  1,  1,  1,  1,  0,  0,  0,  0,  0,  0,  0,  0,  0,  0,  1,  1,  1,  1,  1,  1,  1,  1,  1,  1,  1
      ]
    }
  ]
}